I saw Mr. Maeda wearing a cute T-shirt.	前田さんがかわいいTシャツを着ているのを見た。
Some cheap T-shirts get damaged easily.	安いTシャツは傷みやすいものもある。
They sell T-shirts made of organic cotton.	オーガニックコットンのTシャツを販売している。
I like the T-shirt with a dog wearing sunglasses.	私はサングラスをかけたイヌのTシャツがいいな。
A bear sits holding a fish in its mouth.	クマが魚を口にくわえて座っている。
Oh, what a cute T-shirt!	ああ，なんてかわいいTシャツ！
I’m pleased to hear that you like it.	気に入っていただけてうれしいです。
The cute cat is looking at us with its arms folded.	そのかわいいネコは腕を組んで私たちを見ています。
This is a T-shirt made of organic cotton.	これはオーガニックコットンで作られたTシャツです。
I support clothing manufacturers making organic cotton clothes.	私はオーガニックコットンの服を作っている衣類製造業者を支援しているんだ。
Generally speaking, they don’t contain any harmful chemicals.	一般的に言って，それらには有害な化学物質は含まれていない。
The man eating popcorn is my friend Bill.	ポップコーンを食べている男性は友人のビルです。
This is the picture painted by my father.	これは父が描いた絵です。
The baby kept crying.	赤ちゃんは泣き続けた。
My racket got broken during the match.	私のラケットが試合中に壊れた。
Sorry to keep you waiting.	あなたを待たせてごめんね。
Keep the door locked.	ドアに鍵をかけておきなさい。
I saw Mary crossing the street.	私はメアリーが通りを渡っているのを見た。
I had my hair cut yesterday.	昨日髪をカットしてもらったよ。
I was busy doing my homework.	私は宿題をするのに忙しかった。
My daughter came home disappointed.	私の娘はがっかりして家に帰ってきた。
She accepted the prize, smiling happily.	彼女はうれしそうにほほ笑みながら，賞品を受け取った。
Pleased by her test result, she jumped for joy!	テストの結果がうれしくて，彼女はとび上がって喜んだ。
Having visited New York before, she knew the good restaurants.	以前ニューヨークを訪れたことがあったので，彼女はおいしいレストランを知っていました。
I listened to the music with my heart beating.	私は心を高鳴らせながらその曲を聞いた。
Judging from the sky, it’s going to snow tonight.	空模様から判断すると，今夜は雪が降るね。
