The snowman chocolate is the most popular product this month.	雪だるま型のチョコレートは今月一番人気がある商品です。
The chocolate bar is the second most popular.	その板チョコは二番目に人気があります。
It’s just as sweet as the snowman chocolate.	それは雪だるま型のチョコレートとちょうど同じくらい甘いです。
The chocolate bar is much healthier.	板チョコのほうがずっと健康的です。
The chocolate bar is more expensive than the snowman.	板チョコのほうが雪だるま型よりも値段が高いです。
You’re helping workers by buying it.	それを買うことによって労働者を助けることになります。
Local workers can earn more money.	地元の労働者はより多くのお金を稼ぐことができる。
They can have a more stable life.	彼らはもっと安定した生活を送ることができる。
They are encouraged to use fewer chemicals.	彼らはより少ない化学薬品を使用するよう推奨されている。
The fair trade market in Japan is getting larger and larger.	日本のフェアトレード市場はどんどん大きくなっている。
Tom is as tall as Mary.	トムはメアリーと同じくらいの背の高さだ。
I have as many CDs as Ken.	私はケンと同じくらいの数のCDをもっている。
I’m not as tall as him.	私は彼ほど背が高くない。
Our new cafeteria is twice as large as the old one.	私たちの新しいカフェテリアは以前のものの２倍の広さだ。
Please drive more slowly.	もっとゆっくり運転してください。
I became taller than him.	僕は彼よりも背が高くなった。
Fruit is much cheaper in my country than in Japan.	果物は日本よりも私の国のほうがはるかに安い。
Oh, that’s the best idea.	ああ，それは最高のアイデアですね。
Who speaks English the most fluently in your family?	家族で誰が一番英語をすらすら話しますか。
Tom is the tallest in his class.	トムはクラスでもっとも背が高い。
Tom is the tallest of the three.	トムは３人のうちもっとも背が高い。
Your English is getting better and better.	君の英語，どんどんよくなっているね。
The younger you are, the easier it is to learn.	若ければ若いほど，学ぶのは易しい。
This dictionary is less useful than that one.	この辞書はあの辞書ほど役に立たない。
This is by far the best restaurant in town.	これは断然，街で最高のレストランです。
K2 is the second highest mountain in the world.	K2は世界で２番目に高い山だ。
Boston is one of the oldest cities in the U.S.	ボストンはアメリカでもっとも古い都市の１つです。
